2 2 2 2 2 2 2 2 2 2 2 2 2 2 2 2 2 2 2 2 2 2 2
2 0 0 2 2 0 0 0 0 1 0 2 1 2 2 9 11 11 2 0 0 0 2
2 0 0 0 2 0 1 0 0 0 2 0 0 2 0 0 0 0 0 0 0 0 2
2 0 0 1 11 11 1 0 1 0 9 11 1 1 0 0 0 1 0 0 0 0 2
2 0 0 0 0 0 0 1 1 2 0 1 0 2 0 0 0 0 0 9 0 0 2
2 0 0 1 0 0 2 0 1 0 0 1 2 1 0 0 2 0 1 1 2 0 2
2 0 2 0 1 0 1 0 0 2 0 0 0 0 0 9 0 0 0 0 0 0 2
2 0 0 0 0 0 0 0 9 0 1 11 0 2 0 0 0 1 11 0 0 0 2
2 1 2 0 0 0 2 2 0 0 0 0 1 1 0 2 2 0 0 0 1 0 2
2 0 0 0 0 2 0 0 0 0 0 1 0 0 2 0 0 1 0 0 1 0 2
2 0 0 1 0 0 1 2 0 0 1 1 0 0 11 1 0 11 2 0 0 0 2
2 9 0 0 2 0 0 0 9 11 2 0 0 0 0 0 1 1 2 0 0 0 2 
2 0 0 2 2 0 0 0 0 2 9 0 11 0 0 0 2 1 0 0 0 0 2
2 0 0 0 0 2 2 0 0 0 2 0 0 1 1 1 0 0 11 0 0 0 2
2 9 0 0 1 0 0 9 0 0 0 0 0 0 2 11 0 11 0 0 0 0 2
2 9 11 2 0 0 0 0 0 0 1 1 0 9 9 0 0 0 0 0 11 0 2
2 0 9 2 0 0 0 9 1 2 1 2 1 2 0 0 1 0 2 0 2 0 2
2 1 0 1 0 0 0 0 0 2 1 0 1 0 9 0 0 1 0 0 9 0 2
2 0 0 1 0 2 0 0 0 1 2 0 0 9 0 2 0 1 0 0 1 0 2
2 2 0 0 0 2 9 2 2 0 2 1 0 0 0 0 0 0 0 0 1 0 2
2 0 2 1 9 0 9 1 1 0 0 2 0 1 1 0 0 0 1 0 0 0 2
2 0 0 0 0 0 0 0 0 0 0 0 0 0 0 0 0 0 0 0 0 0 2
2 2 2 2 2 2 2 2 2 2 2 2 2 2 2 2 2 2 2 2 2 2 2
2 3 4 2
