2 2 2 2 2 2 2 2 2 2 2 2 2 2 2 2 2 2 2 2 2 2 2
2 0 0 0 0 0 0 0 0 0 0 0 0 0 0 0 0 0 0 0 0 0 2
2 0 0 0 0 0 9 0 0 0 0 0 0 0 0 0 0 0 0 0 0 0 2
2 0 0 0 0 0 0 0 0 0 0 0 0 0 0 0 0 0 0 0 0 0 2
2 0 0 0 0 0 0 0 0 0 0 0 0 0 0 0 0 0 0 0 0 0 2
2 0 0 0 0 1 1 1 1 1 1 1 1 1 1 1 1 1 0 0 0 0 2
2 0 0 0 0 1 1 1 1 1 1 1 1 1 1 1 1 9 0 0 0 0 2
2 0 0 0 0 1 1 1 1 1 1 1 1 1 1 9 1 1 0 0 0 0 2
2 0 0 0 0 1 1 1 1 1 1 1 1 1 1 1 1 1 0 0 0 0 2
2 0 0 0 0 1 1 1 1 1 1 1 1 1 1 1 1 1 0 0 0 0 2
2 0 0 0 0 1 1 1 1 1 1 1 1 1 1 1 1 1 0 0 0 0 2
2 0 0 0 0 1 1 1 1 1 1 0 1 1 1 1 1 1 0 0 9 0 2
2 0 0 0 0 1 1 9 1 1 1 1 1 1 1 1 1 1 0 0 0 0 2
2 0 0 0 0 1 1 1 1 1 1 1 1 1 1 1 1 1 0 0 0 0 2
2 0 0 0 0 1 1 1 1 1 1 1 1 1 1 1 1 1 0 0 0 0 2
2 0 0 0 0 1 1 1 1 1 1 1 1 1 1 1 1 1 0 0 0 0 2
2 0 0 0 0 1 1 1 1 1 1 1 1 1 1 1 1 1 0 0 0 0 2
2 0 0 0 0 1 1 1 1 1 1 1 1 1 1 1 1 1 0 0 0 0 2
2 0 0 0 0 0 0 0 0 0 0 0 0 0 0 0 0 0 0 0 0 0 2
2 0 0 0 0 0 0 0 0 0 0 0 0 0 0 0 0 0 0 0 0 0 2
2 0 0 11 0 0 0 0 0 0 0 0 0 0 0 0 0 0 0 0 0 0 2
2 0 0 0 0 0 0 0 0 0 0 0 0 0 0 0 0 0 0 0 0 0 2
2 2 2 2 2 2 2 2 2 2 2 2 2 2 2 2 2 2 2 2 2 2 2
1 2 3 4